#domain
hospital
#levelname
BFSFriendly
#colors
blue: 0
#initial
+++++++++++++
+    + +    +
+ ++ + + ++ +
+ +  + +  + +
+ ++++ ++++ +
+     0     +
+ ++++ ++++ +
+ ++ + + ++ +
+    + +    +
+++++++++++++
#goal
+++++++++++++
+    + +    +
+ ++ + + ++ +
+ +  + +  + +
+ ++++ ++++ +
+           +
+ ++++ ++++ +
+ ++ +0+ ++ +
+    + +    +
+++++++++++++
#end